 4 2 2 2 2 2 2 3 
 9 10 10 10 10 10 5 1 
 4 2 2 11 11 11 12 1 
 17 2 2 2 2 18 19 20 
 25 26 2 2 2 6 7 1 
 27 28 21 21 21 8 15 1 
 29 30 22 22 22 13 15 1 
 31 30 23 23 23 14 15 1 
 1 33 24 24 24 16 24 1 
