
 15 2 2 2 2 2 3 1 
 23 10 10 10 10 4 5 6 
 23 18 18 18 18 12 13 14 
 23 18 18 18 18 20 21 22 
 26 2 2 2 2 2 7 8 
 23 10 10 10 10 10 11 1 
 23 16 18 18 18 18 11 1 
 23 24 18 18 18 18 11 1 
 23 9 18 18 18 18 11 1 
 27 17 25 25 25 25 19 1 