 1 2 3 3 3 3 3 6 
 9 10 11 12 12 12 12 1 
 4 18 19 20 20 20 20 1 
 4 22 23 20 20 20 20 1 
 7 8 3 3 3 3 3 6 
 1 16 12 12 12 12 12 1 
 1 16 20 20 20 20 17 1 
 1 16 20 20 20 20 5 1 
 1 16 20 20 20 20 13 1 
 1 14 15 15 15 15 21 1 