 1 1 1 1 1 1 1 1 1 1 3 10 10 10 10 10 
10 10 6 1 
 1 3 10 10 10 10 10 10 10 6 12 5 10 10 10 10 
10 10 10 6 
 3 10 10 10 10 10 10 10 10 7 12 5 10 15 15 15 
9 10 11 1 
 12 15 15 15 15 15 9 10 11 1 3 10 10 10 10 10 
10 10 10 6 
 12 5 10 10 10 10 10 10 10 16 17 5 10 15 15 15 
9 10 11 1 
 3 10 10 15 15 15 9 10 11 18 19 10 10 10 10 10 
10 10 10 6 
 12 5 10 10 10 10 10 10 10 6 12 5 10 15 15 15 
9 10 11 1 
 3 10 10 15 15 15 9 10 11 1 12 5 10 10 10 10 
10 10 13 1 
 12 5 10 10 10 10 10 10 10 6 3 10 10 10 10 10 
10 13 8 1 
 12 20 5 10 10 10 10 10 10 7 12 8 8 8 8 8 
8 8 8 1 
 12 20 20 8 8 8 8 8 8 1 12 8 8 8 8 8 
8 8 1 1 
 14 20 20 8 8 8 8 8 8 1 12 8 8 8 8 8 
8 8 1 1 
 1 14 20 8 8 8 8 8 8 1 14 8 8 8 8 8 
8 1 1 1 
 1 1 14 8 8 8 8 8 8 1 1 1 1 1 1 1 
1 1 1 1 


