
 2 3 3 3 3 3 3 6 0 
 10 11 11 11 11 4 3 3 6 
 7 8 3 3 3 3 3 12 0 
 10 15 16 11 11 11 11 13 0 
 10 17 18 13 13 13 13 13 0 
 10 19 20 13 13 13 13 13 0 
 10 21 22 13 13 13 13 23 0 
 14 9 5 23 23 23 23 0 0 
