 0 0 0 0 0 0 12 13 13 13 13 14 0 0 
0 0 2 3 4 5 15 20 20 20 20 0 0 0 
 0 0 6 7 7 8 12 13 13 13 13 14 0 0 
0 0 9 10 10 11 15 16 16 16 16 7 7 28 
12 13 13 13 13 14 15 17 23 24 17 13 13 33 
 15 16 16 16 16 0 15 17 23 24 17 17 17 0 
 15 17 17 17 17 29 30 17 23 24 17 19 19 0 
18 19 19 19 19 31 32 19 25 26 19 0 0 0 