 1 2 3 4 1 1 1 
 1 10 11 12 1 1 1 
 17 18 19 20 21 22 1 
 24 16 16 16 5 6 7 
 15 16 16 16 25 13 14 
 15 16 16 16 25 8 16 
 15 16 16 16 25 8 16 
 23 16 16 16 1 9 16 