 1 1 1 1 0 1 2 3 4 1 
 9 10 11 12 11 14 15 16 6 1 
 17 18 19 20 19 20 23 24 7 1 
 25 26 27 28 27 28 31 32 8 1 
 33 34 35 36 35 36 39 40 49 5 
 41 42 43 44 43 44 47 48 50 1 
 51 52 38 13 38 13 38 22 50 1 
 53 54 38 21 38 21 38 30 50 1 
 55 45 38 29 38 29 38 37 46 0 