1 2 3 1 1 1 1 0 1 1 1 1 1 1 71 72 
1 1 1 
 1 10 11 12 12 12 12 12 12 12 12 12 12 12 79 80 
1 1 1 
 1 18 19 20 21 22 23 24 67 68 21 22 23 24 87 88 
52 1 1 
 25 26 27 28 29 30 31 32 75 76 77 30 31 32 75 70 
8 66 60 
 33 34 35 36 37 37 37 37 37 37 37 37 37 37 37 78 
36 39 40 
 41 42 43 36 45 46 45 46 83 84 85 86 45 46 45 46 
36 47 48 
 49 50 51 36 53 54 53 54 73 74 81 82 53 54 53 54 
36 55 56 
 57 58 59 36 61 62 61 62 13 14 15 16 61 62 61 62 
36 63 64 
 1 1 9 36 17 89 17 89 4 5 6 7 17 89 17 89 
36 1 1 


