 20 2 2 2 3 1 21 2 2 2 22 
 4 5 5 5 6 1 23 5 5 5 0 
 20 2 2 2 3 1 21 2 2 2 22 
 4 5 5 5 7 8 9 5 5 5 1 
 4 5 5 5 10 11 12 5 5 5 0 
 20 2 2 2 3 1 21 2 2 2 22 
 4 5 5 5 6 1 23 5 5 5 0 
 20 2 2 2 3 1 21 2 2 2 22 
 4 5 5 5 6 1 23 5 5 5 1 
 4 5 5 5 6 1 23 5 5 5 1 
 4 5 5 5 13 14 15 5 5 5 1 
 19 5 5 5 16 17 18 5 5 5 1 