 0 0 0 2 3 4 0 0 
 5 6 7 7 7 7 15 16 
 10 11 12 12 12 12 13 14 
 17 18 26 26 26 26 20 21 
 9 19 19 19 19 19 22 23 
 8 19 19 19 19 19 25 24 