 49 2 3 4 5 6 7 8 61 62 63 64 1 
 9 10 11 12 13 14 15 16 65 65 65 57 1 
 17 18 19 20 21 22 23 24 66 67 67 68 1 
 25 26 27 28 29 30 31 32 69 70 67 67 71 
 33 34 35 36 37 38 39 40 73 74 67 67 75 
 41 42 43 44 45 46 47 48 76 77 67 67 78 
 1 50 51 52 53 54 55 56 81 82 83 84 72 
 1 58 59 60 60 60 60 60 60 60 60 79 80 