 0 0 0 4 5 6 0 
 9 10 11 12 13 14 0 
 17 18 19 20 21 22 0 
 33 26 27 28 28 28 0 
 33 34 35 36 36 36 0 
 33 42 25 36 36 36 0 
 7 2 3 40 29 30 31 
 0 0 0 0 37 38 39 
 0 0 0 0 32 23 24 
 0 0 0 0 8 15 16 