 31 2 2 2 2 2 2 2 2 5 6 
 9 10 10 10 10 10 10 10 10 13 14 
 17 18 18 18 18 3 4 21 21 21 5 
 32 21 21 21 21 11 12 21 21 21 21 
 32 21 21 21 21 19 20 21 21 21 21 
 33 21 21 21 21 7 8 25 22 22 22 
 34 22 22 22 22 15 16 30 1 1 1 
 1 1 1 1 1 23 24 26 1 1 1 
 1 1 1 1 1 27 28 29 1 1 1 


