2 3 4 4 4 4 6 
10 11 12 13 13 13 1 
7 8 5 5 5 5 1 
15 16 4 4 4 4 6 
23 22 13 13 13 13 1 
23 22 5 5 5 5 1 
17 18 5 5 5 5 1 
19 20 9 9 9 9 1 