 17 2 3 1 1 1 1 1 1 17 2 3 
 9 10 11 1 1 1 1 1 1 9 10 11 
 4 5 6 1 1 1 1 1 1 4 5 6 
 12 13 14 1 1 1 1 1 1 15 13 6 
 7 8 23 1 18 19 20 21 1 16 8 23 