 2 3 3 3 3 3 4 1 
 5 6 7 7 7 7 8 1 
 9 11 11 11 11 11 12 13 
 14 15 16 16 16 16 16 23 
 17 18 19 19 20 21 19 22 