 21 2 2 2 2 2 2 25 
 9 10 10 10 10 10 12 7 
 17 20 20 20 20 20 20 15 
 3 4 4 4 4 4 4 23 
 11 10 10 10 10 10 10 14 
 19 20 20 20 20 20 20 22 
 19 13 13 13 13 13 13 22 
 19 13 13 13 13 13 13 22 
 19 13 13 13 13 13 13 8 
 5 20 20 20 20 20 20 16 
