 1 1 1 3 4 5 1 
 1 1 10 11 12 13 14 
 1 1 18 19 20 21 22 
 6 7 8 9 15 16 17 
 23 24 2 2 2 28 29 
 25 26 27 27 27 27 30 
 31 32 32 32 32 32 33 
 35 32 32 32 32 32 34 