 45 2 2 3 4 5 6 
 7 8 8 9 10 11 12 
 13 2 2 3 46 14 15 
 16 17 18 8 19 47 20 
 21 22 23 24 25 26 27 
 28 29 30 31 32 26 26 
 33 34 35 36 37 38 39 
 1 40 41 41 42 43 44 
