 2 3 1 1 1 1 1 
 10 11 12 12 12 12 5 
 4 15 16 16 16 16 1 
 4 15 9 9 9 9 1 
 4 15 9 9 9 9 1 
 14 12 12 12 12 12 5 
 13 8 16 16 16 16 1 
 13 8 9 9 9 9 1 
 13 8 9 9 9 9 1 
 13 8 9 9 9 9 1 
 6 7 7 7 7 7 1 