 2 3 1 1 1 1 1 
 9 10 1 1 1 1 1 
 4 5 14 14 14 14 8 
 11 12 12 12 12 12 12 
 13 12 12 12 12 12 12 
 6 7 7 7 7 7 7 