 0 11 12 13 0 0 0 
 2 3 3 3 3 3 4 
 9 10 10 10 10 10 8 
 9 10 10 10 10 10 8 
 9 10 10 10 10 10 8 
 9 10 10 10 10 10 8 
 9 10 10 10 10 10 8 
 5 6 10 6 10 6 8