  1 2 1 1 1 1 1 1 
 9 10 11 1 1 1 1 1 
 1 18 19 19 19 19 19 20 
 1 17 25 25 25 25 25 1 
 9 22 23 26 26 26 7 1 
 1 18 19 19 19 19 19 20 
 1 17 25 25 25 25 25 1 
 9 22 23 26 26 26 7 1 
 1 18 19 19 19 19 19 20 
 1 4 25 25 25 25 25 1 
 1 4 6 26 26 26 3 8 
 1 4 14 26 26 26 7 16 
 1 4 5 26 26 26 15 24 
 1 12 13 12 12 12 12 21 